11111111
1E000001
10C100C1
10110001
1P0C1001
11111111
