11111111111111111111111111
1000000000000000100W000C01
1C1001011110000010100001P1
1E1001C010101011111001W111
100001000000000000001000C1
11110111111111111110110111
10000000000000000000000001
11111111111111111111111111
