1111111
1000W01
1000001
1P0W0C1
1000E01
1111111
