111111111
1W0C00001
100101011
110C1ECW1
110101111
10P000101
111111111
