1111111
10000C1
1010W01
1P100C1
1W10E01
1111111
