1111111
1000001
1000001
1P000C1
1000E01
1111111
