1111111111111111111111111111111111
100000000000000010000000000W000C01
1C100101111000001010010000000001P1
1E1001C01010101111100111111001W111
10000000000000000000000000000000C1
1111111111111111111111111111111111
