1111111111
1C00010001
10P001C001
100001C001
1000CC0CC1
1001101001
1C0011C001
1C00000001
1E0CCCC001
1111111111
