1111111111111111111111111111111111
1000000000000000000000000000000001
1011111001111100000110011100111101
1010001010000111111001010010100001
1010001010010110001001010010100001
1010001011010110101001010010100001
101110001C010110101001010010101001
1000011011110000101001010010100101
1010001001101111101110010010111101
1011111000000111100000000000000001
10000000000000000000000000C0P000E1
1111111111111111111111111111111111
