11111111
100E0001
100100C1
10110001
1001P001
11111111
