111111111111111111
1000100000000000C1
10CC100100C0000001
10P010C1C000000001
10C01C010000000001
110111110001111111
10CC000000000000C1
10000C0000E10000C1
111111111111111111
